#####################################################
###.....................#####.....................###
###.#######.###########.#####.###########.#######.###
###.#######.###########.#####.###########.#######.###
###...............................................###
###.#######.#####.#################.#####.#######.###
###.#######.#####.......#####.......#####.#######.###
###.........###########.#####.###########.........###
#####.#####.###########.#####.###########.######.####
#####.#####.#####...................#####.######.####
#####.#####.#####.#######...#######.#####.######.####
#####.#####.#####.####.........####.#####.######.####
###...............####.........####...............###
###.#######.#####.#################.#####.#######.###
###.....###...............................###.....###
#######.###.#####.#################.#####.#####.#####
###.........#####.......#####.......#####.........###
###.###################.#####.###################.###
###.###################.#####.###################.###
###...............................................###
#####################################################